/*

example_level.map

Background Tile Map File.
Generated by CloudBoy.

Dimensions: 20,18
Tiles: level.tiles

*/

/* Start of tile array. */
const UBYTE example_level[] = {
	0x01, 0x02, 0x02, 0x02, 0x02, 0x02, 0x02, 0x02,
	0x02, 0x02, 0x02, 0x02, 0x02, 0x02, 0x02, 0x02,
	0x02, 0x02, 0x02, 0x03, 0x04, 0x0a, 0x0b, 0x0a,
	0x0b, 0x0a, 0x0b, 0x0a, 0x0b, 0x0a, 0x0b, 0x0a,
	0x0b, 0x0a, 0x0b, 0x0a, 0x0b, 0x0a, 0x0b, 0x06,
	0x04, 0x0c, 0x0d, 0x0c, 0x0d, 0x0c, 0x0d, 0x0c,
	0x0d, 0x0c, 0x0d, 0x0c, 0x0d, 0x0c, 0x0d, 0x0c,
	0x0d, 0x0c, 0x0d, 0x06, 0x04, 0x2a, 0x2b, 0x0a,
	0x0b, 0x0a, 0x0b, 0x0a, 0x0b, 0x0a, 0x0b, 0x0a,
	0x0b, 0x0a, 0x0b, 0x0a, 0x0b, 0x0a, 0x0b, 0x06,
	0x04, 0x2c, 0x2d, 0x0c, 0x0d, 0x0c, 0x0d, 0x0c,
	0x0d, 0x0c, 0x0d, 0x0c, 0x0d, 0x0c, 0x0d, 0x0c,
	0x0d, 0x0c, 0x0d, 0x06, 0x04, 0x1e, 0x1f, 0x0a,
	0x0b, 0x12, 0x13, 0x0a, 0x0b, 0x16, 0x17, 0x0e,
	0x0f, 0x0a, 0x0b, 0x0a, 0x0b, 0x0a, 0x0b, 0x06,
	0x04, 0x20, 0x21, 0x0c, 0x0d, 0x14, 0x15, 0x0c,
	0x0d, 0x18, 0x19, 0x10, 0x11, 0x0c, 0x0d, 0x0c,
	0x0d, 0x0c, 0x0d, 0x06, 0x04, 0x0a, 0x0b, 0x0a,
	0x0b, 0x0a, 0x0b, 0x0a, 0x0b, 0x0a, 0x0b, 0x0a,
	0x0b, 0x0a, 0x0b, 0x0a, 0x0b, 0x0a, 0x0b, 0x06,
	0x04, 0x0c, 0x0d, 0x0c, 0x0d, 0x0c, 0x0d, 0x0c,
	0x0d, 0x0c, 0x0d, 0x0c, 0x0d, 0x0c, 0x0d, 0x0c,
	0x0d, 0x0c, 0x0d, 0x06, 0x04, 0x0a, 0x0b, 0x0a,
	0x0b, 0x0a, 0x0b, 0x0a, 0x0b, 0x0a, 0x0b, 0x26,
	0x27, 0x0a, 0x0b, 0x0a, 0x0b, 0x0a, 0x0b, 0x06,
	0x04, 0x0c, 0x0d, 0x0c, 0x0d, 0x0c, 0x0d, 0x0c,
	0x0d, 0x0c, 0x0d, 0x28, 0x29, 0x0c, 0x0d, 0x0c,
	0x0d, 0x0c, 0x0d, 0x06, 0x04, 0x0a, 0x0b, 0x0e,
	0x0f, 0x0a, 0x0b, 0x1a, 0x1b, 0x0a, 0x0b, 0x0a,
	0x0b, 0x0e, 0x0f, 0x0a, 0x0b, 0x0a, 0x0b, 0x06,
	0x04, 0x0c, 0x0d, 0x10, 0x11, 0x0c, 0x0d, 0x1c,
	0x1d, 0x0c, 0x0d, 0x0c, 0x0d, 0x10, 0x11, 0x0c,
	0x0d, 0x0c, 0x0d, 0x06, 0x04, 0x0a, 0x0b, 0x0a,
	0x0b, 0x0a, 0x0b, 0x0a, 0x0b, 0x0a, 0x0b, 0x0a,
	0x0b, 0x0a, 0x0b, 0x0a, 0x0b, 0x0a, 0x0b, 0x06,
	0x04, 0x0c, 0x0d, 0x0c, 0x0d, 0x0c, 0x0d, 0x0c,
	0x0d, 0x0c, 0x0d, 0x0c, 0x0d, 0x0c, 0x0d, 0x0c,
	0x0d, 0x0c, 0x0d, 0x06, 0x04, 0x0a, 0x0b, 0x0a,
	0x0b, 0x0a, 0x0b, 0x0a, 0x0b, 0x12, 0x13, 0x0a,
	0x0b, 0x26, 0x27, 0x0a, 0x0b, 0x22, 0x23, 0x06,
	0x04, 0x0c, 0x0d, 0x0c, 0x0d, 0x0c, 0x0d, 0x0c,
	0x0d, 0x14, 0x15, 0x0c, 0x0d, 0x28, 0x29, 0x0c,
	0x0d, 0x24, 0x25, 0x06, 0x07, 0x08, 0x08, 0x08,
	0x08, 0x08, 0x08, 0x08, 0x08, 0x08, 0x08, 0x08,
	0x08, 0x08, 0x08, 0x08, 0x08, 0x08, 0x08, 0x09
};
/* End of example_level.C */
