/*

example_level.map

Background Tile Map File.
Generated by CloudBoy.

Dimensions: 20,18
Tiles: level.tiles

*/

/* Start of tile array. */
const UBYTE example_level[] = {
	0x01, 0x02, 0x02, 0x02, 0x02, 0x02, 0x02, 0x02,
	0x02, 0x02, 0x02, 0x02, 0x02, 0x02, 0x02, 0x02,
	0x02, 0x02, 0x02, 0x03, 0x04, 0x0a, 0x0b, 0x0a,
	0x0b, 0x0a, 0x0b, 0x0a, 0x0b, 0x0a, 0x0b, 0x0a,
	0x0b, 0x0a, 0x0b, 0x0a, 0x0b, 0x0a, 0x0b, 0x06,
	0x04, 0x0c, 0x0d, 0x0c, 0x0d, 0x0c, 0x0d, 0x0c,
	0x0d, 0x0c, 0x0d, 0x0c, 0x0d, 0x0c, 0x0d, 0x0c,
	0x0d, 0x0c, 0x0d, 0x06, 0x04, 0x0a, 0x0b, 0x0a,
	0x0b, 0x0a, 0x0b, 0x0a, 0x0b, 0x0a, 0x0b, 0x0a,
	0x0b, 0x0a, 0x0b, 0x0a, 0x0b, 0x0a, 0x0b, 0x06,
	0x04, 0x0c, 0x0d, 0x0c, 0x0d, 0x0c, 0x0d, 0x0c,
	0x0d, 0x0c, 0x0d, 0x0c, 0x0d, 0x0c, 0x0d, 0x0c,
	0x0d, 0x0c, 0x0d, 0x06, 0x04, 0x0a, 0x0b, 0x0a,
	0x0b, 0x0a, 0x0b, 0x0a, 0x0b, 0x0a, 0x0b, 0x0a,
	0x0b, 0x0a, 0x0b, 0x0a, 0x0b, 0x0a, 0x0b, 0x06,
	0x04, 0x0c, 0x0d, 0x0c, 0x0d, 0x0c, 0x0d, 0x0c,
	0x0d, 0x0c, 0x0d, 0x0c, 0x0d, 0x0c, 0x0d, 0x0c,
	0x0d, 0x0c, 0x0d, 0x06, 0x04, 0x0a, 0x0b, 0x0a,
	0x0b, 0x0a, 0x0b, 0x0a, 0x0b, 0x0a, 0x0b, 0x0a,
	0x0b, 0x0a, 0x0b, 0x0a, 0x0b, 0x0a, 0x0b, 0x06,
	0x04, 0x0c, 0x0d, 0x0c, 0x0d, 0x0c, 0x0d, 0x0c,
	0x0d, 0x0c, 0x0d, 0x0c, 0x0d, 0x0c, 0x0d, 0x0c,
	0x0d, 0x0c, 0x0d, 0x06, 0x04, 0x0a, 0x0b, 0x0a,
	0x0b, 0x0a, 0x0b, 0x0a, 0x0b, 0x0a, 0x0b, 0x0a,
	0x0b, 0x0a, 0x0b, 0x0a, 0x0b, 0x0a, 0x0b, 0x06,
	0x04, 0x0c, 0x0d, 0x0c, 0x0d, 0x0c, 0x0d, 0x0c,
	0x0d, 0x0c, 0x0d, 0x0c, 0x0d, 0x0c, 0x0d, 0x0c,
	0x0d, 0x0c, 0x0d, 0x06, 0x04, 0x0a, 0x0b, 0x0a,
	0x0b, 0x0a, 0x0b, 0x0a, 0x0b, 0x0a, 0x0b, 0x0a,
	0x0b, 0x0a, 0x0b, 0x0a, 0x0b, 0x0a, 0x0b, 0x06,
	0x04, 0x0c, 0x0d, 0x0c, 0x0d, 0x0c, 0x0d, 0x0c,
	0x0d, 0x0c, 0x0d, 0x0c, 0x0d, 0x0c, 0x0d, 0x0c,
	0x0d, 0x0c, 0x0d, 0x06, 0x04, 0x0a, 0x0b, 0x0a,
	0x0b, 0x0a, 0x0b, 0x0a, 0x0b, 0x0a, 0x0b, 0x0a,
	0x0b, 0x0a, 0x0b, 0x0a, 0x0b, 0x0a, 0x0b, 0x06,
	0x04, 0x0c, 0x0d, 0x0c, 0x0d, 0x0c, 0x0d, 0x0c,
	0x0d, 0x0c, 0x0d, 0x0c, 0x0d, 0x0c, 0x0d, 0x0c,
	0x0d, 0x0c, 0x0d, 0x06, 0x04, 0x56, 0x56, 0x56,
	0x56, 0x56, 0x56, 0x56, 0x56, 0x56, 0x56, 0x56,
	0x56, 0x56, 0x56, 0x56, 0x56, 0x56, 0x56, 0x06,
	0x04, 0x00, 0x00, 0x00, 0x00, 0x00, 0x00, 0x00,
	0x00, 0x00, 0x00, 0x00, 0x00, 0x00, 0x00, 0x00,
	0x00, 0x00, 0x00, 0x06, 0x07, 0x55, 0x55, 0x55,
	0x55, 0x55, 0x55, 0x55, 0x55, 0x55, 0x55, 0x55,
	0x55, 0x55, 0x55, 0x55, 0x55, 0x55, 0x55, 0x09
};
/* End of example_level.C */
